###########
..##.#.####
.#.........
#..........
#...@..#...
##........#
..#..#....#
##.......##
##......###
##.....####
###########