#.........#
#..#####..#
#..#......#
#..#@######
#..########
#...###....
###.###..##
##..##..###
##.#...####
##...######
